........
w....w..
.w....w.
..w....w
...w.gw.
...w.bw.
...w..w.