wwwwwww
wp..g.w
w...b.w
w...b.w
wb..w.w
wg..g.w
wwwwwww